000000000000000000000000000011111111111110000000000000000000000
000001111110000000000000000010000000000010000000000000000000000
000001000010000001111111111110000000000011111000000000000000000
000001000010000001000000000010000000000010001000000000000000000
000001000001000001000000000000000000000000001000000000000000000
000001000001000001000000000010000000000010001000000000000000000
000001111111111101000111111110000000000011111000000000000000000
000001000000000101000100000010000000000010000000000000000000000
000001000000000111000111000001111101111110000000000000000000000
000001000000000100000001000000001000100000000000000000000000000
000001000000000000000001000000001000100000000000000000000000000
000001000000000100000001000000001000100000000000000000000000000
111111000000000111111111000000001000100000000000000000000000000
100011000000000100000000000000001000100000000000000000000000000
100011111101111000000000000111111000111000000000000000000000000
100010001000100000000000000100100000001000000000000000000000000
110110001000100000000000000100111000111000000000000000000000000
100011111000100000000000000100111000100000000000000000000000000
100010001000100000000000000100111000100000000000000000000000000
100000001000100000000000000111111000100000000000000000000000000
100010001000100000000000000000001000100000000000000000000000000
100011111101111100000000000000001101100000000000000001111111111
100011000000000100000000001111110000011111110000000001000000001
100011000000000100000000001000000000000000110000000001000000001
100011000000000100000000001000000000000000111111111111000000001
100001000000000100000000001000000000000000010000000001000000001
100000000000000100000000001000000000000000000000000000000000001
100001000000000100000000001000000000000000010000000001000000001
100011000000000100000000001000000000000000111100001111000000001
100011000000000100000000001000000000000000111110010001000000001
100011000000000100000000001111110000011111100010010001000000001
100011111101111100000000000000011101100000000010010001110110111
100011111000100000000000000000001000100000000010010000000000000
100011111000100000000000000000001000100000000010010000000000000
100010001000100000000000000000001000100000000010010000000000000
100000001000100000000000000000001000100000000010011101010101100
100010001000100000000000000000001000100000000010001000000000100
100011111000100000000000000000001000100000000010000000000000100
100011111000111111111111100000001000100000000010001000000000100
100000000000000001000000111000001000100000000011111101010101100
100000000000000000000000101000001000100000000000000000000000000
100000000000000001000000111000001000100000000000000000000000000
111111111111111111111111100000001000100000000000000000000000000
000000000011001001001000000111111101111111000000000000000000000
000000000110001001010000000100001000100001000000000000000000000
000000000011000001100000000100000000000001000000000000000000000
000000000000111111000000000100001000100001000000000000000000000
000000000000100100000000000100001000100001000000000000000000000
000000000000100100000000000111111000111111000000000000000000000
000000000000111100000000000100001000100001000000000000000000000
00000000000000000000000000010P00D000000001000000000000000000000
000000000000000000000000000100001000100001000000000000000000000
000000000000000000000000000111111000111111000000000000000000000
000000000000000000000000000100000000000001000000000000000000000
000000000000000000000000000100000000000001000000000000000000000
000000000000000000000000000100000000000001000000000000000000000
000000000000000000000000000111111111111111000000000000000000000
